10 10 10 10 10 10 10 10 10 10 10 10 10 10 10 10 10 10 10 10 10 10 10 10 10 10 10 10 10 10 10 10 10 10 10 10 10 10 10 10 10 10 10 10 10 10 10 10 10 10
10 10 10 10 10 10 10 10 10 10 10 10 10 10 10 10 10 10 10 10 10 10 10 10 10 10 10 10 10 10 10 10 10 10 10 10 10 10 10 10 10 10 10 10 10 10 10 10 10 10
10 10 10 10 10 10 10 10 10 10 10 10 10 10 10 10 10 10 10 10 10 10 10 10 10 10 10 10 10 10 10 10 10 10 10 10 10 10 10 10 10 10 10 10 10 10 10 10 10 10
10 10 10 10 10 10 10 10 10 10 10 10 10 10 10 10 10 10 10 10 10 10 10 10 10 10 10 10 10 10 10 10 10 10 10 10 10 10 10 10 10 10 10 10 10 10 10 10 10 10
10 10 10 10 10 10 10 10 10 10 10 10 10 10 10 10 10 10 10 10 10 10 10 10 10 10 10 10 10 10 10 10 10 10 10 10 10 10 10 10 10 10 10 10 10 10 10 10 10 10
10 10 10 10 10 10 10 10 10 10 10 10 10 10 10 10 10 10 10 10 10 10 10 10 10 10 10 10 10 10 10 10 10 10 10 10 10 10 10 10 10 10 10 10 10 10 10 10 10 10
10 10 10 10 10 10 10 10 10 10 10 10 10 10 10 10 10 10 10 10 10 10 10 10 10 10 10 0 0 0 10 10 10 10 10 10 10 10 10 10 10 10 10 10 10 10 10 10 10 10
10 10 10 10 10 10 10 10 10 10 10 10 10 10 10 10 10 10 10 10 10 10 10 10 10 10 10 0 0 0 10 10 10 10 10 10 10 10 10 10 10 10 10 10 10 10 10 10 10 10
10 10 10 10 10 10 10 10 10 10 10 10 10 10 10 10 10 10 10 10 10 10 10 10 10 10 10 22 4 23 10 10 10 10 10 10 10 10 10 10 10 10 10 10 10 10 10 10 10 10
10 10 10 10 10 10 10 10 10 10 10 10 10 10 10 10 10 10 10 10 10 10 10 10 10 10 21 24 4 23 10 10 10 10 10 10 10 10 10 10 10 10 10 10 10 10 10 10 10 10
10 10 10 10 10 10 10 10 10 10 17 10 10 10 10 10 10 10 10 10 10 10 10 10 10 21 24 4 2 26 10 10 10 10 10 10 10 10 10 10 10 10 10 10 10 10 10 10 10 10
10 10 10 10 10 10 7 7 7 10 10 10 10 10 10 10 10 10 10 10 10 10 10 10 21 24 4 2 26 10 10 10 10 10 10 10 10 10 10 10 10 10 10 10 10 10 10 10 10 10
10 10 10 10 10 24 4 4 10 10 10 10 10 10 10 10 10 10 10 10 10 10 10 21 24 4 2 26 10 10 10 10 10 10 10 10 10 10 10 10 10 10 10 10 10 10 10 10 10 10
10 10 10 9 22 4 2 5 10 10 10 10 10 10 10 4 27 7 7 0 10 10 10 24 4 2 26 10 10 10 10 10 10 10 10 10 10 10 10 10 10 10 10 10 10 10 10 10 10 10
10 10 10 10 22 4 23 17 10 10 10 10 10 10 25 3 4 4 4 27 10 0 22 4 4 23 0 0 0 0 0 0 0 10 10 10 10 10 10 10 10 10 10 10 10 10 10 10 10 10
10 10 10 9 22 4 23 17 10 10 10 10 10 10 10 25 5 5 3 4 27 10 22 4 4 23 0 0 0 0 0 0 0 0 0 10 10 10 10 10 10 10 10 10 10 10 10 10 10 10
10 10 10 10 22 4 23 10 10 10 10 10 10 10 10 10 10 0 25 3 4 27 24 4 4 23 0 0 0 0 0 0 0 0 0 0 0 10 10 10 10 10 10 10 10 10 10 10 10 10
10 10 10 10 10 10 10 10 10 10 10 10 10 10 10 10 0 17 0 25 3 4 4 4 4 23 0 0 0 9 0 0 0 0 0 0 9 0 10 10 10 10 10 10 10 10 10 10 10 10
10 10 10 10 10 10 10 10 10 10 10 10 10 10 0 0 0 0 0 0 0 5 3 4 4 23 0 10 0 0 0 0 0 0 0 0 0 0 10 10 10 10 10 10 10 10 10 10 10 10
10 10 10 10 10 10 10 10 10 10 10 10 10 0 0 17 0 0 0 0 0 0 22 4 4 23 0 0 0 0 0 0 10 0 0 0 0 0 10 10 10 10 10 10 10 10 10 10 10 10
10 10 10 10 10 10 10 10 10 10 10 10 0 0 0 0 0 17 0 17 0 0 22 4 4 23 0 0 0 9 0 0 0 0 0 0 0 0 12 10 10 10 10 10 10 10 10 10 10 10
10 10 10 10 10 10 10 10 10 10 10 0 0 17 0 0 0 0 0 0 0 21 24 4 4 23 0 0 0 0 0 0 0 9 0 0 12 12 12 10 10 10 10 10 10 10 10 10 10 10
10 10 10 10 10 10 10 10 10 10 0 0 0 0 0 0 0 0 0 0 21 24 4 4 2 26 0 0 0 0 0 0 0 0 12 12 12 12 12 10 10 10 10 10 10 10 10 10 10 10
10 10 10 10 10 10 10 10 10 10 0 0 0 0 0 0 17 0 0 21 24 4 4 2 26 0 0 0 9 0 0 0 0 0 12 12 12 12 12 12 10 10 10 10 10 10 10 10 10 10
10 10 10 10 10 10 10 10 10 10 10 0 10 0 0 0 0 0 0 22 4 4 2 26 0 10 0 0 0 0 0 0 17 0 12 12 12 0 0 0 10 10 10 10 10 10 10 10 10 10
10 10 10 10 10 10 10 10 10 10 10 0 0 0 0 0 0 0 0 22 4 4 23 0 0 0 17 0 0 0 0 0 0 0 12 12 0 0 9 0 10 10 10 10 10 10 10 10 10 10
10 10 10 10 10 10 10 10 10 10 10 7 7 7 7 7 7 7 7 24 4 4 27 7 7 7 7 6 0 0 0 0 0 9 0 0 0 0 0 10 10 10 10 10 10 10 10 10 10 10
10 10 10 10 10 10 10 10 10 10 10 4 4 4 4 4 4 4 4 4 4 4 4 4 4 4 4 27 7 7 6 0 0 0 0 0 0 0 0 10 10 10 10 10 10 10 10 10 10 10
10 10 10 10 10 10 10 10 10 10 10 4 4 4 4 4 4 4 4 4 4 4 4 4 4 4 4 4 4 4 27 0 0 0 0 0 0 0 0 10 10 10 10 10 10 10 10 10 10 10
10 10 10 10 10 10 10 10 10 10 10 5 5 3 4 4 2 5 5 5 5 5 5 5 5 3 4 4 4 4 4 27 6 0 0 0 0 0 0 10 10 10 10 10 10 10 10 10 10 10
10 10 10 10 10 10 10 10 10 10 10 0 0 22 4 4 23 0 0 0 0 0 0 0 0 25 5 5 3 4 4 4 23 0 0 0 0 0 10 10 10 10 10 10 10 10 10 10 10 10
10 10 10 10 10 10 10 10 10 10 10 0 0 22 4 4 23 0 0 10 0 0 0 0 0 0 0 0 25 3 4 4 23 10 0 0 0 0 10 10 10 10 10 10 10 10 10 10 10 10
10 10 10 10 10 10 10 10 10 10 0 0 0 22 4 4 27 6 0 0 0 0 0 0 0 17 0 0 0 22 4 4 23 10 0 0 0 0 10 10 10 10 10 10 10 10 10 10 10 10
10 10 10 10 10 10 10 10 10 10 0 0 0 25 3 4 4 23 0 0 0 0 0 10 0 0 0 10 0 22 4 4 23 0 0 0 0 0 0 0 10 10 10 10 10 10 10 10 10 10
10 10 10 10 10 10 10 10 10 10 0 0 0 0 22 4 4 23 0 0 0 0 0 0 0 0 0 0 0 22 4 4 23 0 0 0 0 0 0 0 10 10 10 10 10 10 10 10 10 10
10 10 10 10 10 10 10 10 10 10 0 0 0 0 22 4 4 23 0 0 0 0 0 0 0 0 0 0 0 22 4 4 23 0 10 10 0 0 0 0 10 10 10 10 10 10 10 10 10 10
10 10 10 10 10 10 10 10 10 10 0 0 0 0 22 4 4 23 0 0 17 0 0 0 0 0 0 0 0 22 4 4 27 0 0 0 0 0 0 0 10 10 10 10 10 10 10 10 10 10
10 10 10 10 10 10 10 10 10 10 0 0 0 0 22 4 4 23 0 0 0 0 0 0 10 0 0 0 0 22 4 4 4 27 0 0 0 0 0 0 10 10 10 10 10 10 10 10 10 10
10 10 10 10 10 10 10 10 10 10 0 0 0 0 22 4 4 23 0 0 0 0 0 0 0 0 0 0 0 25 3 4 4 4 27 7 7 7 7 7 10 10 10 10 10 10 10 10 10 10
10 10 10 10 10 10 10 10 10 10 10 0 0 0 22 4 4 23 0 0 0 0 0 0 0 0 0 0 0 0 25 3 4 4 4 4 4 4 4 4 10 10 10 10 10 10 10 10 10 10
10 10 10 10 10 10 10 10 10 10 10 10 0 0 22 15 4 23 0 0 0 0 0 17 9 0 0 17 0 0 0 25 3 4 4 4 4 4 4 4 10 10 10 10 10 10 10 10 10 10
11 11 11 11 11 11 11 11 11 11 11 11 11 11 11 15 15 11 11 13 0 0 0 0 0 0 0 0 0 0 0 0 25 5 5 5 5 5 5 5 10 10 10 10 10 10 10 10 10 10
1 1 1 1 1 1 1 1 1 1 1 1 1 1 1 1 15 1 1 14 11 11 11 11 11 11 11 11 11 11 11 11 11 11 11 11 11 11 11 11 11 11 11 11 11 13 10 10 10 10
1 1 1 1 1 1 1 1 1 1 1 1 1 1 1 1 1 1 1 1 1 1 1 1 1 1 1 1 1 1 1 1 1 1 1 1 1 1 1 1 1 1 1 1 1 14 11 11 13 10
1 1 1 1 1 1 1 1 1 1 1 1 1 1 1 1 1 1 1 1 1 1 1 1 1 1 1 1 1 1 1 1 1 1 1 1 1 1 1 1 1 1 1 1 1 1 1 1 14 11
1 1 1 1 1 1 1 1 1 1 1 1 1 1 1 15 15 1 1 1 1 1 1 1 1 1 1 1 1 1 1 1 1 1 1 1 1 1 1 1 1 1 1 1 1 1 1 1 1 1
1 1 1 1 1 1 1 1 1 1 1 1 1 1 1 1 1 1 1 1 1 1 1 1 1 1 1 1 1 1 1 1 1 1 1 1 1 1 1 1 1 1 1 1 1 1 1 1 1 1
1 1 1 1 1 1 1 1 1 1 1 1 1 1 1 1 1 1 1 1 1 1 1 1 1 1 1 1 1 1 1 1 1 1 1 1 1 1 1 1 1 1 1 1 1 1 1 1 1 1
1 1 1 1 1 1 1 1 1 1 1 1 1 1 1 15 15 1 1 1 1 1 1 1 1 1 1 1 1 1 1 1 1 1 1 1 1 1 1 1 1 1 1 1 1 1 1 1 1 1
1 1 1 1 1 1 1 1 1 1 1 1 1 1 1 1 1 1 1 1 1 1 1 1 1 1 1 1 1 1 1 1 1 1 1 1 1 1 1 1 1 1 1 1 1 1 1 1 1 1
