10 10 10 10 0 0 0 0 0 0 0 0 0 0 0 0 0 0 0 0 10 10 10 0 0 0 0 0 0 0 0 0 0 10 10 10 10 10 10 10 10 10 10 10 10 0 0 10 0 0 
10 0 0 10 0 0 15 15 15 15 15 15 15 0 0 10 0 0 0 0 10 0 0 0 0 0 10 10 0 0 0 0 0 0 0 0 0 15 15 15 15 15 15 15 0 0 10 10 0 0 
0 0 0 0 0 0 15 15 15 15 15 15 15 0 0 0 0 0 0 10 0 0 0 0 0 0 0 10 10 10 10 10 0 0 0 0 0 15 15 15 15 15 15 15 0 10 10 0 0 0 
0 0 10 0 0 0 15 15 16 16 16 15 15 0 0 0 0 0 0 0 0 0 0 0 0 0 0 0 0 0 0 0 0 0 0 0 0 15 15 16 16 16 15 15 0 0 10 0 0 0 
0 0 0 10 0 0 15 15 16 16 16 15 15 15 15 15 15 15 15 15 15 15 15 15 15 15 15 15 15 15 15 15 15 15 15 15 15 15 15 16 16 16 15 15 0 0 10 0 0 0 
10 0 0 10 0 0 15 15 16 16 16 15 16 16 16 16 16 16 16 16 16 16 16 16 16 16 16 16 16 16 16 16 16 16 16 16 16 16 15 16 16 16 15 15 0 0 10 10 0 0 
10 0 0 10 10 0 15 15 15 15 15 15 15 15 15 15 15 15 15 15 15 15 15 15 15 15 15 15 15 15 15 15 15 15 15 15 15 15 15 15 15 15 15 15 0 0 0 10 0 0 
10 10 0 0 10 0 15 15 15 15 16 15 15 0 10 10 15 15 15 15 15 15 15 15 15 15 15 15 15 15 15 15 15 15 10 10 0 15 15 16 15 15 15 15 0 0 0 10 0 0 
10 10 10 0 10 0 0 0 0 15 16 15 0 0 10 10 15 15 15 15 15 15 15 15 15 15 15 15 15 15 15 15 15 15 10 10 0 0 15 16 15 0 0 0 0 0 0 10 0 0 
10 10 10 10 10 10 10 0 0 15 16 15 0 0 0 0 15 15 15 15 15 15 15 15 15 15 15 15 15 15 15 15 15 15 0 0 0 0 15 16 15 0 10 10 10 0 10 10 0 0 
0 10 10 0 0 10 10 0 0 15 16 15 0 0 15 15 15 15 15 15 15 15 15 15 15 15 15 15 15 15 15 15 15 15 15 15 0 0 15 16 15 0 10 0 10 10 0 10 10 0 
0 0 10 0 0 10 10 0 0 15 16 15 0 0 15 16 16 15 15 15 15 15 15 15 15 15 15 15 15 15 15 15 15 16 16 15 0 0 15 16 15 0 10 0 10 0 10 0 10 0 
0 0 0 0 10 10 0 0 0 15 16 15 0 0 15 16 16 15 17 17 17 17 15 16 16 16 16 15 17 17 17 17 15 16 16 15 0 0 15 16 15 0 10 10 0 10 10 10 0 0 
0 0 10 10 0 0 0 0 0 15 16 15 0 0 15 15 15 15 17 17 17 0 0 0 0 0 0 0 0 17 17 17 15 15 15 15 0 0 15 16 15 0 10 10 10 10 0 10 0 0 
10 10 10 0 0 0 0 0 0 15 16 15 0 0 0 0 0 0 0 0 0 0 0 0 0 0 0 0 0 0 0 0 0 0 0 0 0 0 15 16 15 0 0 10 0 0 0 10 0 0 
0 0 0 0 0 10 0 0 0 15 16 15 0 0 0 0 0 0 0 0 0 0 0 0 0 0 0 0 0 0 0 0 0 0 0 0 0 0 15 16 15 0 10 10 0 0 10 0 0 0 
0 0 0 10 10 10 0 0 0 15 16 15 0 0 0 0 0 0 0 0 0 0 0 0 0 0 0 0 0 0 0 0 0 0 0 0 0 0 15 16 15 0 10 0 0 10 10 0 0 0 
0 0 0 0 0 0 0 0 0 15 16 15 0 0 0 0 0 0 0 0 0 0 0 0 0 0 0 0 0 0 0 0 0 0 0 0 0 0 15 16 15 0 10 10 10 10 0 0 0 0 
0 0 0 0 0 10 0 0 0 15 16 15 0 0 0 0 0 0 0 0 0 0 0 0 0 0 0 0 0 0 0 0 0 0 0 0 0 0 15 16 15 0 0 10 10 0 0 0 0 0 
0 0 0 0 0 10 0 0 0 15 16 15 0 0 0 0 0 0 0 0 0 0 0 0 0 0 0 0 0 0 0 0 0 0 0 0 0 0 15 16 15 0 0 10 10 10 10 0 0 0 
0 0 0 0 10 10 0 0 0 15 16 15 0 0 0 0 0 0 0 0 0 0 0 21 7 7 7 7 6 0 0 0 0 0 0 0 0 0 15 16 15 0 0 0 10 10 0 0 0 0 
0 0 0 0 10 0 0 0 0 15 16 15 0 0 0 0 0 0 0 0 0 0 21 24 4 4 4 4 23 0 0 0 0 0 0 0 0 0 15 16 15 0 10 10 10 10 0 0 0 0 
0 10 0 0 10 0 0 0 0 15 16 15 0 0 0 0 0 0 0 0 0 21 24 4 4 4 4 4 23 0 0 0 0 0 0 0 0 0 15 16 15 0 10 10 0 0 10 0 0 0 
0 10 10 10 10 0 0 0 0 15 16 15 0 0 0 0 0 0 0 0 0 22 4 4 4 4 4 4 23 0 0 0 0 0 0 0 0 0 15 16 15 0 0 0 0 0 0 10 10 0 
0 0 10 10 0 0 15 15 15 15 15 15 15 0 0 0 0 0 0 0 0 22 4 4 4 4 4 4 23 0 0 0 0 0 0 0 0 15 15 15 15 15 15 15 0 0 0 0 0 0 
0 0 10 10 10 10 15 15 15 15 15 15 15 15 15 15 15 15 15 15 15 15 4 4 4 4 4 4 15 15 15 15 15 15 15 15 15 15 15 15 15 15 15 15 0 0 0 0 0 0 
0 0 0 10 0 0 15 15 16 16 16 15 15 16 16 16 16 16 16 16 16 15 4 4 4 4 4 4 15 16 16 16 16 16 16 16 16 15 15 16 16 16 15 15 0 0 0 0 10 10 
0 0 0 10 10 0 15 15 16 16 16 15 15 15 15 15 15 15 15 15 15 15 4 4 4 4 4 4 15 15 15 15 15 15 15 15 15 15 15 16 16 16 15 15 0 0 10 10 10 10 
10 0 0 0 10 0 15 15 16 16 16 15 15 0 0 0 0 0 0 0 10 22 4 4 4 4 4 4 23 10 0 0 0 0 0 0 0 15 15 16 16 16 15 15 10 10 10 0 10 0 
10 0 0 0 10 0 15 15 15 15 15 15 15 0 0 0 0 0 0 0 10 22 4 4 4 4 4 4 23 10 0 0 0 0 0 0 0 15 15 15 15 15 15 15 0 10 0 0 0 0 
10 10 0 0 10 0 15 15 15 15 15 15 15 0 0 0 0 0 0 0 10 22 4 4 4 4 4 4 23 10 0 0 0 0 0 0 0 15 15 15 15 15 15 15 0 0 10 0 0 10 
10 0 0 0 10 0 0 0 0 0 0 0 10 10 10 10 10 0 0 0 10 22 4 4 4 4 4 4 23 10 0 0 0 0 0 0 0 0 0 0 0 0 0 0 0 0 0 0 0 0 
10 0 10 0 10 10 10 0 0 0 10 10 10 0 0 0 0 0 10 0 10 22 4 4 4 4 4 4 23 10 0 0 0 0 0 0 0 0 0 0 0 0 0 0 0 10 0 0 10 10 
10 0 10 10 10 0 0 10 10 0 0 0 0 0 0 0 10 10 0 0 10 22 4 4 4 4 4 4 23 10 0 0 0 0 0 0 10 0 0 10 0 0 10 0 0 0 0 0 10 10 
10 0 10 10 10 0 0 18 0 0 0 0 10 10 10 10 0 0 0 0 10 22 4 4 4 4 4 4 23 10 0 0 0 0 0 10 10 0 0 0 0 0 0 0 0 0 0 10 10 10 
0 10 10 10 10 10 0 0 0 0 10 18 0 0 0 0 0 0 10 10 10 22 4 4 4 4 4 4 23 10 10 10 10 0 0 0 0 0 0 0 0 0 0 0 0 0 0 0 0 0 
10 10 0 10 10 10 0 10 0 0 0 0 0 0 18 0 0 10 10 10 10 10 4 4 4 4 4 4 23 10 10 10 0 0 0 0 0 10 0 0 10 0 0 0 0 0 0 0 0 0 
0 0 10 0 10 0 0 0 10 0 0 0 0 0 0 10 10 10 10 10 10 10 4 4 4 4 4 4 10 10 10 10 0 0 0 0 0 0 0 10 0 10 0 10 10 0 0 10 10 10 
0 10 10 0 0 10 10 10 10 10 10 10 10 10 0 10 0 10 10 10 10 10 10 4 4 4 4 10 10 10 10 10 10 0 0 0 10 0 0 0 10 0 0 10 10 0 10 0 10 10 
0 10 0 0 0 0 0 0 10 10 0 0 0 0 0 10 10 0 10 10 10 10 10 10 4 4 10 10 10 10 10 10 0 0 0 10 0 0 0 0 0 0 10 10 0 0 10 0 10 10 
0 10 0 10 0 0 10 0 0 0 0 0 10 10 10 0 10 10 0 10 10 10 10 10 10 10 10 10 10 10 10 10 10 10 10 10 0 0 10 10 10 0 0 0 0 0 10 0 10 10 
10 0 0 10 0 10 10 10 0 10 10 10 0 10 10 0 10 10 0 10 10 10 10 10 10 10 10 10 10 10 10 10 10 10 10 10 10 10 0 0 0 0 0 0 10 0 10 0 10 10 
0 18 0 10 0 10 10 0 10 10 10 0 18 0 0 0 10 10 10 0 10 10 0 0 0 10 10 10 10 10 10 10 10 0 0 0 0 10 0 10 0 0 10 10 10 0 10 0 10 10 
0 0 10 0 0 10 0 0 0 0 0 10 10 0 10 0 10 10 10 10 10 0 10 10 0 0 0 0 0 0 0 0 0 0 10 10 10 0 0 0 0 0 0 0 0 0 0 0 0 10 
0 0 0 10 0 0 0 0 0 0 0 0 0 0 10 10 10 10 0 10 0 0 0 0 0 0 10 10 10 10 10 0 10 10 0 0 0 18 0 10 0 0 0 10 0 18 0 0 0 10 
10 10 10 10 0 0 0 0 0 18 0 0 0 0 0 0 10 0 0 0 0 18 18 0 0 0 10 10 10 10 10 0 10 10 10 10 0 0 0 0 0 18 0 0 0 10 10 0 10 10 
10 10 0 0 0 0 18 0 0 0 0 0 10 0 0 0 0 18 0 0 0 0 10 0 0 0 10 10 10 10 0 0 10 10 10 0 0 10 10 0 0 0 0 0 0 10 0 10 10 10 
10 10 0 0 10 10 0 0 19 0 0 0 0 0 0 0 0 0 0 0 0 0 0 0 0 0 10 0 0 0 0 10 0 10 10 0 10 10 0 0 0 0 0 0 10 0 10 10 10 10 
10 10 10 10 10 10 10 10 0 0 0 0 0 0 0 18 0 0 10 10 10 10 10 10 10 10 10 10 10 10 10 10 10 10 0 0 0 0 0 18 0 0 0 0 0 0 0 0 0 0 
10 10 10 10 10 10 10 10 10 10 10 0 0 0 0 0 0 0 0 10 10 10 10 10 10 10 10 10 10 10 10 10 10 10 0 10 10 0 0 0 0 0 0 0 0 0 0 0 0 0 
